######
#  P #
#o####
# #
#O#
###
==========
######
#P   #
#  Oo#
# oO #
######
==========
#####
#P  ##
#oOO #
#  # #
#    #
######
==========
